NO img/MARBFAC2.xpm
SO img/SKULWALL.xpm
WE img/MARBFACE.xpm
EA img/SKULWAL3.xpm

F 220,255,150 
C 225,200,100   

        111111111111111111111111111             
        100000000011000000000000001
        101100000111000000000000001
        100100000000000000000000001
11111111101100000111000000000000001
1000000000110000011101111100001111111111111
11110111111111011100000010001001110011000011111
11110111110000000000010100001010100100001111111
11000100011010000N00000000000100100010000000001      
1000100000010000000000000010000100000000111111111
1001000000010000011010100000000100000000000011111111111
11100001110101011111011100000010110000000001111111
11110111 1110101 1011110100000100001000000011111
11111111 11111011 11111111000111111111111111
            1001        11101
            101         111111
            101
          1110111111 
        1110000111111
        110000011
        100000001111111
        100000000000001
        100000001111111
        1000000000000111
        100010001111111
        1101110011
        111111111