NO img/north.xpm
SO img/south.xpm
WE img/west.xpm
EA img/east.xpm

F 220,255,150 
C 225,200,100   

        1111111111111111111111111             
        1000000000110000000000001
        1011000001110000000000001
        1001000000000000000000001
111111111011000001110000000000001
1000000000110000011101111100001111111
11110111111111011100000010000000000011
111101111111111101110101000000W00000001
11000100011010101110000000000000000001      
10001000000100000011000000110000000001111
10010000000100000110101000000011111111111
11100001110101011111011100001111111
11110111 1110101 101111010001
11111111 1111111 111111110001111
                        11011
                        11111
 
 
        11111
        100001
        1000001
        1111111