NO img/north.xpm
SO img/south.xpm
WE img/west.xpm
EA img/east.xpm

F 220,255,150 
C 225,200,100   

        111111111111111111111111111             
        100000000011000000000000001
        101100000111000000000000001
        100100000000000000000000001
11111111101100000111000000000000001
1000000000110000011101111100001111111111111
11110111111111011100000010001001110011000011111
11110111111111110111010100001010100100001111111
11000100011010101110000000000100100010000000001      
10001000000100000011000000110000100000000111111111
1001000000010000011010100000000100000000000011111111111
11100001110101011111011100000010110000000001111111
11110111 1110101 1011110100000100001000000011111
11111111 1111111 11111111000111111111111111
                        11011
                        11111
 
          1111111111 
        1110000111111
        110000011
        100000001111111
        1000S0000000001
        100000001111111
        1000000000000111
        100010001111111
        1101110011
        111111111