NO img/north.xpm
SO img/south.xpm
WE img/west.xpm
EA img/east.xpm

F 220,255,150 
C 225,200,100   

        1111111111111111111111111             
        1000000000110000000000001
        1011000001110000000000001
        1001000000000000000000001
111111111011000001110000000000001
1000000000110000011101111100001111111
11110111111111011100000010000001
11110111111111011101010000000001
11000000110101011100000000000001      
10000000000000001100000010W01111
1000000000000000110101000000011111111111
110000011101010111110111000111
11110111 1110101 101111010001
11111111 1111111 111111110001111
                        11011
                        11111
 
 
        11111
        100001
        1000001
        1111111