11111


        1111111111111111111111111
        1000000000110000000000001
        1011000001110000000000001 
        1001000000000000000000001       
111111111011000001110000000000001 111        
100000000011000001110111111111111 1001      
111101111111110111000000100011     11        
11110111111111011101010010001               
100000011010101110000001000111    1111      
10000000000000001100000010001   111001      
10000000000000001101010010001   101001         
11000001110101011111011110N01111111111      
11110111 1110101 101111010001111111111    
1111111111 11111111 111111111111  



11
10111
10001
11111
                       111111111
                       101010101
                       111111111